1111111111111111111111111111111111
1000010000000000000000100000000001
1000010000000060000000100000000001
1000010000000000000000100000000001
1000011111111110001000100011110001
1000010000000000001000100000010001
1000010000555000001000100000010001
1000010000000000001000100000010001
1000010001111110001000111100011111
1000010001000000001000000000000001
1000010001000000001000000000000001
1000010001000000001000000000000001
1000010001000111111000111111110001
1000033301000000000000100000000001
1300000331000000000000100000006001
1000000001000000000000100000000001
1111111111000111111111100011111111
1000000000000000000000100000000001
1666666666666666666666100000000001
1000000000000000000000100000000001
1111111111111111111111111111111111